*******************************
* R          *    *         R *
*     *       *  H  *    *    *
*           *     *           *
*  RR *       R            R  *
*******************************