*************************
*     ****     ****     *
*    *    *   *    *    *
*   *       *       *   *
*   *               *   *
*     *     H     *     *
*       *       *       *
*         *   *         *
*           *           *
*************************