                 10 x 45
*******O*******++++***********++++++++*******
*  R        R       **  R              *+   *
*   R *  *  *    *+    *  **++++            *
*          +      *     *   R    *+     *   O
*   +*     *   +    H  ++   **         R  * *
*   *  R    +  *    *   *   *        *  *   *
*     * +    R  +   R    *    *+            *
*  *           **   *  *    *       R   *   +
*     R      *    *    * R      **          *
*++*********+++++++**********O*******+*******