8 x 30
**********************O*******
*             R              *
*    R             *     *   *
O      R        *           R*
*                  *    *    *
*   R     R      ***  **   ***
*                        H   *
******************************